##################
#................#
#........-.......#
#................#
#................#
#...#.#######....#
#...#.#.....#....#
#...#.#.###.#....#
#...#.#..@#.#....#
#...#.#####.#....#
#...#.......#....#
#...#########....#
#................#
#................#
#................#
##################